NO textures/wall/lava.png
SO textures/wall/water1.png
EA textures/wall/dead2.png
WE textures/wall/dead3.png

F 44,117,255
C 0,255,113

                111111111111111111111111111111111111111111111111111111111111111111111111111111111111111111111111111111111111111111111111111111
                100000000000000020000000000000000000000000100000000000000000000000000000000000000000000000000000000000000000000000000000000001
                100000000000000011111111111111111111111111111111111111111111111111111111111111111111111111111111111111111111111111111111111001
          11111110000000000000001                                                                                                         1001
          10000020000000000000001                                                                                                         1001
          10111111111111211111111                        111111                                                                           1001
          101          101                               11010111111111                                                                   1001
          101   11111111011111111                       11000000000001                                                                    1001
          101   100000001000000011111111111111111111111111010010010011111111111111111111111111111111111111111                             1001
          101   101000001000001020000000000000000000000000000000000002000000000000000000000000000000000000001                             1001
1111111111101   100000000000000011111111111111111001111111111111211111111111111111111111111111111111111111001                             1001
1000000000001   10001000100010001               1001           101                                       10011111111111111111111111111111112111111111111111111111111
1001111111111   10000000000000001               1001           101111111111111111                        10000000000000000000000000000000000000000000000000000000001
1001      11111110101010001010101               1001           100000000000000201                        11111111111111111111111111111111111111111111111111111111101
1001      10000020000000000000001           111110011111       111111112111111101                                                                                101
1001      10011111111111111111111           100000000001              101     101                                                                                101
1001      1001                              100000000001              101     101                           11111111111111111111111111111111111111111111111111111101
10011111111111111111111111111111111111111111100010010001111111111111111111111110111111111111111111111111    10000000000000000000000000000000000000000000000000000001
10000000002000000000000000000000000000000000000000000000000000000000000000000020200000000000000000002001    10111111111111111111111111111111111111111111111111111111
11111111111001111111121111111111111111111111111112111111111111111121111111111110111111111111111111111111    101
          1001    100010001                     100001                        101                   1011    101
          1111  11111111211111111              100001                         101   111             1211    101111111111111111111111111111111111111111111111111111111
          1001  10000000000000001              100001                         101   101             1001    100000000000000000000000000000000000000000000000000000001
          10011110100000100000101               1011                          101   101             1001    111111111111111111111111111111111111111111111111111111101
          10000020000000000000001111111111111111121111111111111111111111111111101   101             1001                                                          101
          11111110001000100010000000010000000000000000000000000000000000000000001   101             1001                                                          101
                10000000000000001111111111111111111111111111121111111111111111111   101             1001    111111111111111111111111111111111111111111111111111111101
                10101010001010101          1001             10000000000201          101             1001    100000000000000000000000000000000000000000000000000000001
                10000000000000001           1001            11111111111101          101             1001    101111111111111111111111111111111111111111111111111111111
                10001000100100001            1001           1001       101          101             1001    101
                10000000000000001             1001         1001        101          101             1001    101111111111111111111111111111111111111111111111111111111
                10100000100001001111111111111  1001       1001         101          101             1001    1000000000000000000000000000000000000000000000000000000001
                10000000000000000000000000001   1001     1001          101          10111111111111  1001    1111111111111111111111111111111111111111111111111111111101
                11111111111111111111111111101    1001   1001           101          10000000000201  1001                                                           101
                                         11211    1001 1001            101          11111111111101  1001                                                           101
                                        110001111  10011001            101                     101  1001    1111111111111111111111111111111111111111111111111111111101
11111111111111111                       1100000001  100001             101                     101  1001    1000000000000000000000000000000000000000000000000000000001
100000000000000011111111111111111111111111010010011  1001              101                     101  1001    1011111111111111111111111111111111111111111111111111111111
1010000010000010200000000000000000000000000000000001  1001             101                     101  1001    101
10000000000000001111111111111111100111111111111101111  1001            101                     101  1001    101
10001000100010001               1001           121      1001           101                     101  1001    10111111111111111111111111111111111111111111111111111111111
10000000000000001               1001           101111111121111111      101                     101  1001    10000000000000000000000000000000000000000000000000000000001
10101010001010101               1001           100000000000000001      101                     101  1001    11111111111111111111111111111111111111111111111111111111101
10000000000000001           111110011111       111111111111111101      101                     101  1001                                                            101
10001000100100001           100000000001                      121      101                     101  1001                                                            101
10000000000000001           100000000001                      101      101                     101  1001                                                            101
10100000100001001111111111111000100100011111111111111111111111101111111121111111111111111111111121111211111111111111111211111111111111111111111111111111111111111111121
10000000000000000000000000000000000000000000000000000000000000000000000000100000000000000000000000000000000000000000000000000000000000000000000000000000000000000000001
11111011111111111111111111111000100100011111111111111111111111111111111111121111111111111111111111111111111111111111111111111111111111111111111111111111111111111112111
    121                     100000000001                      101111111111101       102000000000000000000000000000000000000000000000000000000000000000000000000000001
11111011111111111           100000000001                      102000000000001       101111111111111111111111111111111111111111111111111111111111111111111111111111101
10000000000000001           111110011111                      101111111111111       101                                                                           101
10100000100000101               1001                          101                   101                                                                           101
100000000000000011111111111111111001111111111111111111111111111211111111111111111111101                     11111111111111111111                                  101
100010001000100020000000000000000000000000000000000000000000000000000000000000000000201                     10000000000000000001                                  101
10000000000000001111111111111111111111121111111111111111111111111111111111111111111110111111111111111111111110111111111111111101                                  101
10101010001010101                     101                                           102000000000000000000000201              101                                  101
10000000000000001                     101                                           101111111111111111111111101              101                                  101
100010001001000011111111111111111111111211111111111111111111111111111111111111111111101                     101              101                                  101
100000000000000020000000000000000000002020000000000000000000000000000000000000000000001          11111111111101              101                                  101
101000001000010011111111111111111111111111121111111111111111111111111121111111111111111          10000000000001              101                                  101
10000100000000001                        1001                        1001                        10111111111111              101                                  101
10000000000000001                       1001                          1001                       101                         101    111111111111111111111111111111101
10010000000010001                      1001                            1001                      111                         101    100000000000000000000000000000001
10000000000000001                     1001                              1001                                                 101    111111111111111111111111111111101
10000001000000001111111111111111111111121111111111111111111111111111111111211111111111111111111111111111111111111111111111111101                                  101
11000000N00000002000000000000000000000020200000000000000000000000000000000000000000000000000000000000000000000000000000000000001                                  101
11111111111111111111111111111111111111111111111111111111111111111111111111111111111111111111111111111111111111111111111111111111                                  101
1                                                                                                                                                                 101
1                                                                                                                                                                 111
