NO textures/wall/metal1.png
SO textures/wall/metal2.png
EA textures/wall/metal3.png
WE textures/wall/rock2.png

F 255,251,253
C 1,0,0

111111111111111111111111111111111111111111
100000000010000000000100000000000010000001
100000000010000000000100000000000010000001
100000000010000000000000000000000010000001
100000000010000000000100000000000010000001
100000000000000000000000000000000010000001
100000000010000000000000000000000010000001
1000N0000000000000000100000000000010000001
100000000000000000000100000000000000000001
100000000010000000000100000000000000000001
111111111111111111111111111111111111111111
