NO textures/wall/metal1.png
SO textures/wall/metal2.png
EA textures/clusters/workspace.png
WE textures/wall/rock2.png

F 255,251,253
C 1,0,0

11111111111
10000000001
10000000001
100000N0001
10000000001
11111111111
