NO textures/wall/metal1.png
SO textures/wall/metal2.png
EA textures/wall/metal3.png
WE textures/wall/rock2.png

F 255,251,253
C 1,0,0

111111111111111111111111111111111111111111111
1000000001 10000000000000000000000000000000001
10000000001000000010010000000000000000000000001
1000000000111110010000100000000000000000011111
1000000001     100000100000010000000000001
100000000011111100000000100000000000000001
100000000000000010000001000000000000000001
1000N0000000000001000010000000000000000001
100000000000000000100100000000000000000001
100000000000000000000000000000000000000001
111111111111111111111111111111111111111111
