NO textures/wall/metal1.png
SO textures/wall/metal2.png
EA textures/wall/metal3.png
WE textures/wall/rock2.png

F 82,47,11
C 73,66,255

111111111111111111111111111111111111111111111
100000000000000000000000000000000000000000001
100000000000000000000000000000000000000000001111
100000000000001111110000000000000000000000000001111
1000000000000110000000000000000000000000000000000001
1000000000000011111100000001000000000000000011111111
1000000000000000000000000001000000000000000011
10000000000000000000000000000000000000000000001111
100001010000000000000000000000100000000000000000011
10001W01000000000000000000100000000000000000011111
100001010000000000000000000000000000000000001
11111111111111111111111111111111111111111111

