NO textures/wall/metal1.png
SO textures/wall/metal2.png
EA textures/wall/metal3.png
WE textures/wall/rock2.png

F 82,47,11
C 73,66,255

11111111111111111111111111111
10000000001100000000000000001
10110000011100000001111011111
11111111110000000000000000011111
        10110000011100000000000111111
        1000000000110000011111111111
11111111111111011100000010001
11110111111111011101010010001
11000000110101011100000010001
11111111000000001100000010001
       10000000000000001100011111111
    11110000110101000000000011111
11111111100101000000000000001
1111111112111111111111112111111
10000000000000000000000001001
10000000111100010000N00001001
100000001  100110101110000001
10000000111110000001 10100001
11111111111111111111 11111111


