NO textures/wall/metal1.png
SO textures/wall/metal2.png
EA textures/clusters/workspace.png
WE textures/wall/rock2.png

F 255,251,253
C 1,0,0

111111111111
1         11
1          1
111111111111
100000000001
11111S111111
11		   1
111111111111
