NO textures/wall/metal1.png
SO textures/wall/metal2.png
EA textures/clusters/workspace.png
WE textures/wall/rock2.png

F 255,251,253
C 1,0,0

1111111111111111111111111111
1000001000000001000000000101
1000001011110001000000000001
100000001  10000000000000101
100000101  10001000000000101
1000001001100000000000000001
1000000000000001000000000101
1000001000N00001000000000101
1111111111111111111111111111
