NO ./images/walls/walln.xpm42
SO ./images/walls/walls.xpm42
EA ./images/walls/walle.xpm42
WE ./images/walls/wallw.xpm42

F 255,251,253
C 1,0,0

111111111111111111111111111111
100000001000000000000000000001
100000000000001111000111111111
100000000000001111111000000001
100000000000001111000000011111
100000000000001111000000000011
100000000000000000000000000011
100000000000000000000000000001
100000000000011110000000000001
100000000000000000000000000001
100000000000000000000000000001
100000000000000000000000000001
111111111111111111111111111111
