NO ./images/walls/wall1.xpm42
SO ./images/walls/wall1.xpm42
EO ./images/walls/wall1.xpm42
WE ./images/walls/wall4.xpm42

F 252,251,253
C 0,0,0

11111111111111111111111111111111111111
100000001000000000000000000000000000001
10000000000000111110000000001111111111
100000000000001111111110000000001
100000000000001111100000000011111
100000000000001111000000000011
100000000000000000000000000011
100000000000000000000000000001
100000000000011110000000000001
100000000000000000000000000001
100000000000000000000000000001
100000000000000000000000000001
111111111111111111111111111111
