NO ./images/walls/wall1.xpm42
SO ./images/walls/wall1.xpm42
EA ./images/walls/wall1.xpm42
WE ./images/walls/wall4.xpm42

F 255,255,255
C 0,0,0

111111111111111111111111111111111
100000000000000000000000000000001
100000000000000000000000000000001
100000000000000000000000000000001
100000000000000000000000000000001
100000000000000000000000000000001
100000000000000000000000000000001
100000000000000000000000000000001
100000000000000000000000000000001
100000000000000000000000000000001
100000000000000000000000000000001
100000000000000000000000000000001
111111111111111111111111111111111
