NO textures/wall/lava.png
SO textures/wall/water1.png
EA textures/wall/dead2.png
WE textures/wall/dead3.png

F 111,111,111
C 155,100,299

1111111111111111
10000000000000001
10100000100000101
10000000000000001
10001001111110001
10000001   100001
101010101N1110101
10000000000000001
10001000100100001
10000000000000001
10100000100001001
10000000000000001
11111111111111111
